121111111
122222221
111111121
111111121
111222221
111211111
111211111
111211111
